RRRRRRRRRRRRR
GGGRRRRRRRRRR
GGGRRRRGRRRRG
GGGRRRRRRRRRR
RRRRRRRRRRRRR