RRRRRRRRRRRR
RGGGRRRRRGRR
RGGGRRRRGGGR
RGGGRRRRRGRR
RRRRRRRRRRRR